
##############

### #####   ###
###  #####  B 
##   ####### ###
###   ####### ##
####A#####